###############################
#p     ** *  1 *  *  * * *   #
# # # #*# # #*#*# # # #*#*#*# #
#  x*     ***  *  1   *  * * #
# # # # # #*# # #*#*# # # # #*#
#f         x **  *  *   1     #
# # # # # # # # # #*# #*# # # #
#*  *      *  *  2   *        #
# # # # #*# # # #*#*# # # # # #
#*  2 **  *       *           #
# #*# # # # # # #*# # # # # # #
#           *   *  *          #
###############################