###############################
#      ** *    *   *  * * *   #
# # # #*# # #*#*# # # #*#*#*# #
#         ***  *      *   * * #
# # # # # #*# # #*#*# # # # #*#
#            **  *  *         #
# # # # # # # # # #*# #*# # # #
#          *  *      *        #
# # # # #*# # # #*#*# # # # # #
#*    **  *       *           #
# #*# # # # # # #*# # # # # # #
#           *   *  *          #
###############################